11111111111111111111111
12333333333333333333331
13333333333333333333331
13333433333433333333331
13333333333333334335331
13333533333333333333331
13333333333533335333331
13333333333333333334331
11111111111111111111111